{:name   "Amazed"
 :layout ["###############"
          "#........#....#"
          "#..#..........#"
          "##........#...#"
          "#......#......#"
          "#.....#.......#"
          "#..........#..#"
          "#.............#"
          "#.#....#..#..##"
          "#.............#"
          "###############"]
 :player [3 8]
 :boxes  [[4 7]]
 :goals  [[4 8]]}